11111111111111
100C0000000001
10000E11110001
100000P0000001
1C00C001000001
1C00C001000001
1C00C001000001
11111111111111